6 6 6 6 6 6 6 3 3 3 3 3 3 3 3 3 3 3 3 3 3 3 3 3 6 6 6 6 6 6 6 6 
6 6 6 6 3 3 3 1 1 1 1 2 2 1 1 1 1 1 1 1 1 1 2 1 3 3 3 6 6 6 6 6 
6 6 6 3 1 1 1 1 1 1 1 1 2 2 1 1 1 11 1 1 1 1 1 1 1 1 1 3 6 6 6 6 
6 6 6 3 1 1 1 3 1 11 1 3 1 1 1 3 1 1 1 3 1 1 1 3 1 1 1 3 6 6 6 6 
0 0 0 9 0 5 0 9 0 0 0 9 0 10 0 9 0 5 0 9 0 10 0 9 0 0 0 9 0 0 0 0 
0 0 0 17 0 0 0 17 0 0 0 17 0 10 0 17 0 0 0 17 0 10 0 17 0 0 0 17 0 0 0 0 
0 0 0 17 0 0 0 17 0 0 0 17 0 10 0 17 0 0 0 17 0 10 0 17 0 0 0 17 0 0 0 0 
0 0 0 17 0 0 0 17 0 0 0 17 18 19 20 17 0 0 0 17 18 19 20 17 0 0 0 17 0 0 0 0 
0 0 0 17 0 0 0 17 0 0 0 17 26 27 28 17 0 0 0 17 26 27 28 17 0 0 0 17 0 0 0 0 
0 0 0 17 0 0 0 17 0 0 0 17 0 0 0 17 0 0 0 17 0 0 0 17 0 0 0 17 0 0 0 0 
0 0 0 17 0 0 0 17 0 0 0 17 0 0 0 17 0 0 0 17 0 0 0 17 0 0 0 17 0 0 0 0 
0 4 0 25 0 4 0 25 0 4 0 25 0 0 0 25 0 4 0 25 0 14 0 25 0 4 0 25 0 0 4 0 
12 12 12 3 12 12 12 3 12 12 12 3 12 12 12 3 12 12 12 3 12 12 12 3 12 12 12 3 12 12 12 12 
13 13 13 13 13 13 13 13 13 13 13 13 13 13 13 13 13 13 13 13 13 13 13 13 13 13 13 13 13 13 13 13 
6 6 6 6 6 6 6 6 6 6 6 6 6 6 6 6 6 6 6 6 6 6 6 6 6 6 6 6 6 6 6 6 
6 6 6 6 6 6 6 6 6 6 6 6 6 6 6 6 6 6 6 6 6 6 6 6 6 6 6 6 6 6 6 6